NO ./textures/north.xpm
SO ./textures/south.xpm
WE ./textures/west.xpm
EA ./textures/east.xpm

F 127,127,127
C 50,50,55

    111111111111
    100000000001
    111111111111
    101010101011
    100000000001
    100000001001
1111100000000001
10000000000000001111
11111000000000N00001
    1111111111111111
