
C 100,100,100
F 120,122,104

NO ./textures/lab/tile040.xpm
SO ./textures/lab/tile043.xpm
WE ./textures/lab/tile044.xpm
EA ./textures/lab/tile101.xpm


                                11111111111111111
                                10000000000000001
                                10111111111111101
                                10111000000001101
                                10111111110111101
                                10000000010000001
                                11111111D11111111
                                       101
                                       101
                                       101
                                       101
                                       101
                                       101
111111111111111111111111111111111111111101
1+00000000D0000000000000000000000000000001
100000000+11111111111111111111111111111111
1+00000000D0000000000000000000000001
100000000+11111111111111111111111011
1+0000000N111000000000000000000000011111111
11111111111110011111111111000111111000000+1
            1000000000000100000000000000001
            1000000000000100000000000000001
            1000000001111111111000000000001
            1000000001000000001000000000001
            1+000000000000000010000000000+1
            1111111111111111111111111111111
