





F 220,100,0
C 225,30,0

NO ./textures/north.xpm
SO ./textures/south.xpm
WE ./textures/west.xpm
EA ./textures/east.xpm


111111111111111111111111111111111111
110000000000000000000000000000000001
10000N000000000000000011111111100001
110000000000000000000000000000000001
100000000011111111111111111111111011
100000000010000000000000000000000001111111
111111111111000000000000010000000000000000
            0000000000000100000000000000001
            100000000000010000000000000001
            1000000001111111111000000000001
            1000000001000000001000000000001
            10000000000000000000000000000001
            1111111111111111111111111111111111
