NO ./textures/lab/tile040.xpm
SO ./textures/lab/tile043.xpm
WE ./textures/lab/tile044.xpm
EA ./textures/lab/tile101.xpm

C 100,100,100
F 120,122,104

        111111111      11111111111         111111111  11111111111
       1100000001     11000000011         1100000001  101111111111
      11001111001    11001111111         11001111001  101      11
     110011  1001   110011              110011  1001  101     11
    1100111111001  110001              1100111111001  101111111
   11000000000001  110001             11000000000001  10011111111
  110011111111001   110011           110011111111001  1001     111
 110011      1001    11001111111    110011      1001  1001      111
 10N111      1001     11000000011   100111      1001  1001111111111
 1111        11D1      11D1111D111  1D11        1D11  1D1111111111
11111111111111101       10111101    101111111111101   1011111111111
1111111111111110111111111011110111111010000000001011111011111111111
1111111111111110000000000011110000000010000000001000000011111111111
1111111111111111111111111111111111111111111111111111111111111111111
