





C 100,100,100
F 120,122,104

NO ./textures/lab/tile040.xpm
SO ./textures/lab/tile043.xpm
WE ./textures/lab/tile044.xpm
EA ./textures/lab/tile101.xpm


                                11111111111111111
                                10000000000000001
                                10111111111111101
                                10111000000001101
                                10111111110111101
                                10000000010000001
                                11111111011111111
                                       101
                                       101
                                       101
                                       101
                                       101
                                       101
111111111111111111111111111111111111111101
100000000000000000000000000000000000000001
10000N000011111111111111111111111111111111
100000000000000000000000000000000001
100000000011111111111111111111111011
1000000000111000000000000000000000011111111
1111111111111001111111111100011111100000001
            1000000000000100000000000000001
            1000000000000100000000000000001
            1000000001111111111000000000001
            1000000001000000001000000000001
            1000000000000000001000000000001
            1111111111111111111111111111111
