NO ./textures/lab/tile040.xpm
SO ./textures/lab/tile043.xpm
WE ./textures/lab/tile044.xpm
EA ./textures/lab/tile101.xpm

C 100,100,100
F 120,122,104

                                                111111
        11111111111111111111111111111111111111111000011
      11100000000000000000000000000000000000000000000+11
    111000000011000000000000000000000000000000000000001
  11100000000001111111111111111111111111111111111100011
1110000000000000011                             111111
11000000000000000011
110000000N0000000011
11100000000000000111
  1110000000000111
    111000000111
      11111111
