
NO ./textures/north.xpm
SO ./textures/south.xpm
WE ./textures/west.xpm
EA ./textures/east.xpm

F 127,127,127
C 50,50,50

111111
1+00+1
101111
100001
100001
1000011111
1000N00001
1111111111
