
NO   ./textures/north.xpm
SO    ./textures/south.xpm
WE      ./textures/west.xpm
EA    ./textures/east.xpm



F 127,127,127
C 50,50,50


1111
1N01
1001
1111
