NO ./textures/north.xpm
SO ./textures/south.xpm
WE ./textures/west.xpm
EA ./textures/east.xpm

F 127,127,127
C 50,50,50

11111111
10000001
101d1001
10000001
1000N001
11111111
