
NO   ./textures/north.xpm
SO    ./textures/south.xpm
WE      ./textures/west.xpm
EA    ./textures/east.xpm



F 127,127,127
C 50,50,50

111111111
100000001
100000001
1001N0001
100000001
100000001
111111111
