NO ./textures/north.xpm
SO ./textures/south.xpm
WE ./textures/west.xpm
EA ./textures/east.xpm

F 127,127,127
C 50,50,50

111111111111
100000000001
111111111111
101010101011
100000000001
100000001001
100000000001
100000000001
1000000000N1
111111111111
