C 50,50,50
F 127,127,127

F 127,127,127
C 50,50,50

C 0,0,0
F 127,127,127

NO ./textures/north.xpm
SO ./textures/south.xpm
WE ./textures/west.xpm
EA ./textures/east.xpm

1111111
1000001
100N001
1000001
1111111
