

NO ./textures/north.xpm
SO ./textures/south.xpm
WE ./textures/west.xpm
EA ./textures/east.xpm

F 127,127,127
C 50,50,50

 1111111
 1000001
 1000001
 100t001
 1000001
 1000N01
 1111111
