

NO ./textures/north.xpm
SO ./textures/south.xpm
WE ./textures/west.xpm
EA ./textures/east.xpm

F 127,127,127
C 50,50,50

11111111111111111111
10000000000000000001
10000000000000000001
100N000001d000000001
10000000000000000001
10000000000000000001
11111111111111111111
