NO ./textures/north.xpm
SO ./textures/south.xpm
WE ./textures/west.xpm
EA ./textures/east.xpm

F 127,127,127
C 50,50,50

111111
1N0001
100D01
100001
100001
111111
