NO ./textures/north.xpm
SO ./textures/south.xpm
WE ./textures/west.xpm
EA ./textures/east.xpm

F 127,127,127
C 50,50,50

111111
100101
100111
100101
1000N1
111111
