
NO ./textures/north.xpm
SO ./textures/south.xpm
WE ./textures/west.xpm
EA ./textures/east.xpm

F 127,127,254
C 50,50,50

1111111
1000001
1000E01
1000001
1000001
1000001
10000011111
10000000001
11101111111
