
C 100,100,100
F 120,122,104

NO ./textures/lab/tile040.xpm
SO ./textures/lab/tile043.xpm
WE ./textures/lab/tile044.xpm
EA ./textures/lab/tile101.xpm


                                11111111111111111
                                10000000000000001
                                10000000000000001
                                10000000000000001
                                10000000000000001
                                10000000000000001
                                11111111D11111111
                                       101
                                       101
                                       101
                                       101
                                       101
                                       101
111111111111111111111111111111111111111101
100000+000D0000000000000000000000000000001
1000000000111111111111111111111111D1111111
1000000000D0000000000000000000000001
100000000011111111111111111111111001
1+000N0000DDD000000000000000000000011111111
1111111111111111111111111100011111D100000+1
            1000000000000100000000000000001
            1000000000000100000000000000001
            1000000001111111111000000000001
            100000000000000000D000000000001
            1+000000000000000010000000000+1
            1111111111111111111111111111111
